00000000
00000000
00000000
00000000
0003////
////////
////////
///////W
